XXXXXXX
X     X
X     X
X     X
X     X
Xa    X
XXXXXXX
