XXXXXXX
X     X
X     X
X  a  X
X     X
X     X
XXXXXXX
