XXXXXXXXXXX
Xf    d  eX
X         X
Xb       gX
X         X
X a      cX
X         X
Xf       hX
Xs       bX
X  d  e   X
XXXXXXXXXXX
