XXXXXXXXXXXXXXXXXXXXXXXXXXXXXXXXXXXXXXXXXXXXXXXXXX
X                                                X
X                                                X
X                                                X
X                                                X
X                                           a    X
X                                              h X
X                                       d      f X
X                                                X
X                  a                             X
X                   d                            X
X                                                X
X                                                X
X                                                X
X                                e               X
X                                                X
X                                                X
X   f                            c f             X
X                                                X
X                                                X
X                              b                 X
X                                       d        X
X                              d                 X
X                           a         c          X
X                                                X
X                        A                       X
X                                             g  X
X  b                                             X
X                                                X
X                                 d              X
X                                                X
X                                                X
X                         e                      X
X                                                X
X                                                X
X                                                X
Xg     f                       a                 X
X                                                X
X                                                X
X                                                X
X                                                X
X             f                                  X
X                                                X
X                                        h       X
X                                                X
X                                                X
X                                      a         X
X                                                X
X                                                X
XXXXXXXXXXXXXXXXXXXXXXXXXXXXXXXXXXXXXXXXXXXXXXXXXX
