XXXXXXX
Xe    X
X     X
X    aX
X     X
Xe    X
XXXXXXX
