XXXXXXXXXXX
Xf       eX
X         X
X     b   X
X         X
X a      cX
X         X
X     b   X
X         X
X  d      X
XXXXXXXXXXX
