XXXXXXXXXXX
X   b     X
Xb        X
X       b X
X       b X
X a     b X
X         X
X         X
X aa      X
X        cX
XXXXXXXXXXX
