XXXXXXXXXXXXXXX
X             X
X       d     X
X         b   X
X             X
X e         g X
X             X
X      A      X
X       c    bX
X             X
X            aX
X      e      X
X       f     X
Xdc a         X
XXXXXXXXXXXXXXX
