XXXXXXXXXXX
X         X
X a       X
X     b   X
X         X
X       a X
X         X
X     b   X
X a       X
X         X
XXXXXXXXXXX
