XXXXXXXXXXX
Xf    d  eX
X         X
Xb       gX
X         X
X a      cX
X         X
Xf        X
X        bX
X  d  e   X
XXXXXXXXXXX
